13 bar blues	13_bar_blues
25 or 6 to 4	25_or_6_to_4
720 in the books!	720_in_the_books
A gothic romance (red roses for the devil's whore)	a_gothic_romance_(red_roses_for_the_devil's_whore)
Ageispolis	ageispolis
aie/i try	aie_i_try
Ain't it time	ain't_it_time
Ain't no sunshine	ain't_no_sunshine
Albumblatt	albumblatt
Alone	alone
Always on my mind	always_on_my_mind
Annie's song	annie's_song
Alienz	armand_alienz
The boogie monster	armand_boogiemonster
Mother earth	armand_motherearth
Outrageous	artfuld_outrageous
Re-rewind	artfuld_rerewind
R u ready	artfuld_ruready
Something always happens	artofnoise_something
Autumn in New York	autumn_in_new_york
Avalon	avalon
Baby please don't go	baby_please_don't_go
Back door man	back_door_man
Bad	bad
Bad, bad Leroy Brown	bad_bad_leroy_brown
Bad, bad whiskey	bad_bad_whiskey
West side blues	barrelhouse_harris
Ain't gonna be your dog no more	barrelhouse_parrish
New Orleans blues	barrelhouse_stewart
Be healthy	be_healthy
Beauty slept in Sodom	beaty_slept_in_sodom
Been caught stealing	been_caught_stealing
Been had	been_had
Ouverture Fidelio, op.72	beethoven_fidelio
sonate no.14 C sharp minor op27 no 2: adagio sostenuto (Moonlight sonata)	beethoven_moonlight
Symphony no.5in C major: allegro con brio	beethoven_symphony5
Being boring	being_boring
Berceuse	berceuse
Sonata à 7	biber_sonata
Big blow	big_blow
Birdland	birdland
Black& blue	black_&_blue
Black magic woman	black_magic_woman
Black Night	black_night
Black or white	black_or_white
Bomba	bomba
Brandenburg concerto no.5 D major: Affettuoso	brandenburg_d_affettuoso
Brandenburg concerto no.2 F major : Allegro	brandenburg_f_allegro
Let it flow	braxton_letitflow
There's no me without you	braxton_nome
Un-break my heart	braxton_unbreak
Brazen (Weep)	brazen(weep)
Standing on higher ground	brown_higherground
Show me	brown_showme
It's time to love (put a little love in your heart)	brown_timetolove
Bumble-bee boogie	bumble-bee_boogie
Bury Me Deep Inside Your Arms	bury_me_deep_inside_your_heart
Introduktion und elegie für klarinette, zwei violinen, viola und violoncello: rondo: allegro scherzando	busoni_elegie
Buzzin' baby	buzzin_baby
Café del Ma	cafedelmar_energy52
Can you feel it	can_you_feel_it
Carol of the bells	carol_of_the_bells
Cavalleria rusticana	cavalleria_rusticana
Chanela	chanela
Charley's Prelude	charley's_prelude
Charly	charly
Cheeseballs in Cowtown	cheeseballs_in_cowtown
Mazurka no.47 in a minor op.68 no.2	chopin_mazurka47
Closer than close	closer_than_close
Coinleach ghlas an fhómhair	coinleach_ghlas_an_fhómhair
Colour my world	colour_my_world
Concerto no.2 for trumpet= II-grave (composed in 1954)	concerto_no.2_for_trumpet_II_grave
Contradictive	contradictive
The devil is dope	coolio_devil
2 minutes & 21 seconds of funk	coolio_funk
Hit 'em	coolio_hitem
Corcovado	corcovado
I didn't know that funk was loaded (count Funkula)	count_funkula
Crayola	crayola
Cry your heart out	cry_your_heart_out
Danca da solidao	danca_da_solidao
Dance Freak	dance_freak
Dark eye tango	dark_eye_tango
Dear friends	dear_friends
Deck the halls	deck_the_halls
It's no good	depechemode_nogood
Personal Jesus	depechemode_personaljesus
Enjoy the silence	depechemode_silence
Desafinado	desafinado
Dogon A.D.	dogon_ad
Dogs of war	dogs_of_war
Don't stay out all night	don't_stay_out_night_all_night
Don't mess with my man	dont_mess_with_my_man
Drained	drained
Dream for him	dream_for_him
Can't stop raving	dune_raving
El bandolero	el_bandolero
El Choclo	el_choclo
El choclo	el_choclo2
Scream bloody core	elektro_deisix
Inside your world	elektro_fuzebox
Space divider	elektro_neuroactive
Totes Fleisch	elektro_terminalchoice
Empty corner	empty_corner
En bateau	en_bateu
En resa	en_resa
Epic	epic
Eppure non t'amo	eppune_non_t'amo
Etude, op.25 No.9 in G flat major	etude_op25_no9
Everybody shake your body (electro mix)	everybody_shake_your_body
Everyday	everyday
Everything's gone green (Advent remix)	everything's_gone_green
Ezio	ezio
Faust (ballet): adagio	faust_adagio
Fingerbib	fingerbib
Fireworks music, Concerto grosso no.26 D major: La paix	fireworks_lapaix
Ave regina caelorum	flemish_delarue
j'ay pris amours	flemish_obrecht
Passe et medio & reprise	flemish_susato
Entre du fol	flemish_susato_entredufol
Gaillarde	flemish_susato_gaillarde
Pavane&Gaillarde; "la Dona"	flemish_susato_ladona
Flowers in the rain	flowers_in_the_rain
Fly away	fly_away
Follow me	follow_me
For free	for_free
For you I will	for_you_i_will
For your love	for_your_love
Forever	forever
Forty days and forty nights	forty_days_and_forty_nights
Carnival of the animals	fossils
Frankie and Kevin	frankie_and_kevin
Frasquita serenade	frasquita_serenade
Free bird	free_bird
Canzon no.1, 1615	ggabrieli_canzon
Angel	goldie_angel
Gone till November	gone_till_november
Got the Life	got_the_life
Ground hog blues	ground_hog_blues
Peer Gynt suite no.1 op.46: Anitra's dance	gynt_anitra
Peer Gynt suite no.1 op.46: Death of ase	gynt_deathofase
Peer Gynt suite no.2 op.55: Solveij's song	gynt_solveij
Sonata in A-dur op.5/1: andante-adagio	handel_sonata1_1
Sonata in A-dur op.5/1: allegro	handel_sonata1_2
Sonata in A-dur op.5/1: larghetto - allegro	handel_sonata1_3
Sonata in A-dur op.5/1: gavotte (allegro)	handel_sonata1_4
Sonata in e minor: andante larghetto - adagio	handel_sonata3_1
Sonata in e minor: allegro	handel_sonata3_2
Sonata in e minor: sarabande (largo assai)	handel_sonata3_3
Sonata in e minor: allemande (andante allegro)	handel_sonata3_4
Sonata in e minor: rondeau	handel_sonata3_5
Sonata in e minor: gavotte (allegro)	handel_sonata3_6
Hands up!	hands_up
Handsome boy (e wara)	handsome_boy
Hard knock life	hard_knock_life
Harder, better, faster, stronger	harder_better_faster_stronger
Harlequin	harlequin
Have you ever seen the rain	have_you_ever_seen_the_rain
Heart of the night	heart_of_the_night
Heartland	heartland
Heliosphan	heliosphan
Heprealaisten orjien kuoro	heprealaisten_orjien_kuoro
(wish I could) Hideaway	hideaway
Hip hop	hip_hop
Horn concerto nr.2 Es Major Andante	horn_concerto_nr.2_es_major_andante
Hot like a sauna	hot_like_a_sauna
Hotel California	hotel_california
How blue can you get	how_blue_can_you_get
How bout some hardcore	how_bout_some_hardcore
How I could just kill a man	how_i_could_just_kill_a_man
How long can this go on?	how_long_can_this_go_on
How many times	how_many_times
How much is the fish	how_much_is_the_fish
Human nature	human_nature
Hummingbird	hummingbird
Humours of Lissadell/Music in the glenn/ Johnson's	humours_of_lissadell_music_in_the_glen_johnson's
Hungarian dance number 1 in G minor	hungarian_dance_number_1_in_g_minor
Hungarian march	hungarian_march
I believe I can fly	i_believe_i_can_fly
I found my smile again	i_found_my_smile_again
I got rhythm	i_got_rhythm
I just want to be	i_just_want_to_be
I love you baby	i_love_you_baby
I loved another woman	i_loved_another_woman
I turn to you	i_turn_to_you
I used to love him	i_used_to_love_him
I Wanna Wake Up With You	i_wanna_wake_up_with_you
I will survive	i_will_survive
If you Techolectro	if_you_techolectro
In the mood	in_the_mood
Mary Mary	innercircle_mary
We 'a' rockers	innercircle_rockers
Standing firm	innercircle_standingfirm
Inside out	inside_out
Into the groove	into_the_groove
It's just a thought	it's_just_a_thought
It's alright for you	its_alright_for_you
It's raining men	its_raining_men
Jacques your body (make you sweat)	jacques_your_body
Jalat maassa	jalat_maassa
Jalousie	jalousie
Jane says	jane_says
Journey of 1,000 years	journey_of_1000_years
Symphony no.41 in C major, Jupiter: Allegro	jupiter_allegro
Kettle whistle	kettle_whistle
Kiss of life	kiss_of_life
It's gonna take all our love	knight_ourlove
Love overboard	knight_overboard
You	knight_you
Konception	konception
Funky stuff	kool_funkystuff
Jungle boogie	kool_jungleboogie
Spirit of the boogie	kool_spiritofboogie
Hollywood swinging	kool_swinging
Kuolema op.44: Valse Triste	kuolema_valsetriste
L'Inverno	l'inverno
Ladies of the canyon	ladies_of_the_canyon
Lady my whole world is you	lady_my_whole_world_is_you
Last mass of the caballeros	last_mass_of_the_caballeros
Last night on earth	last_night_on_earth
Last train to Clarksville	last_train_to_clarksville
Bad risk	latimore_badrisk
Lay all your love on me	lay_all_your_love_on_me
Lazarus	lazarus
Le Coucou	le_coucou
Leaves and sand	leaves_and_sand
Let's stay together	let's_stay_together
Let forever be	let_forever_be
Zwei elegische melodien nach gedichten von A.O.Vinje für Streichorchester:Letzter Frühling	letzter_fruhling
Notturno no.3, Liebestraum	liebestraum
Like a virgin	like_a_virgin
Live in Berlin	live_in_berlin
Lochs of dread	lochs_of_dread
Long distance call to heaven	long_distance_call_to_heaven
Long hot sexy nights	long_hot_sexy_nights
Look at me	look_at_me
Looking forward	looking_forward
Lost ones	lost_ones
Love don't live here anymore	love_don't_live_here_anymore
Love me do	love_me_do
Love song	love_song
Love story	love_story
Love to the 3 oranges= march	love_to_the_3_oranges-_march
Lowdown thing or two	lowdown_thing_or_two
Lucky	lucky
Lucy Pearl's way	lucy_pearls_way
Machine gun	machine_gun
Mad hatter's den	mad_hatters_den
Magic carpet ride	magic_carpet_ride
Malagueña	malaguena
Man! I feel like a woman	man!_i_feel_like_a_woman
Maple leaf rag	maple_leaf_rag
Marbles	marbles
Mariposa (part 1)	mariposa(part1)
Toccata	martini_toccata
Somewhere over the rainbow	marusha_rainbow
Mary	mary
master blaster	master_blaster
The day X	mayday_dayx
The end of the rainbow	mckinley_rainbow
Mediterranean sundance	mediterranean_sundance
Lieder ohne worte op.19, no.2 a-moll: andante espressivo	mendelssohn_op19no2
Lieder ohne worte op.19, no.5 fis-moll: piano agitato	mendelssohn_op19no5
Lieder ohne worte op.30, no.6 fis-moll: allegretto tranquillo	mendelssohn_op30no6
Menta e Rosmarino	menta_e_rosmarino
Message in a bottle	message_in_a_bottle
Quintett Es-dur: allegro moderato	meyerbeer_allegromoderato
A midsummer night's dream. Dance of the clowns	midsummer_clowns
A midsummer night's dream. Notturno. Con moto tranquillo	midsummer_notturno
A midsummer night's dream. Wedding march	midsummer_wedding_march
Mind sex	mind_sex
Minnen	minnen
Mira pa'ca	mira_pa'ca
Misery	misery
Mist on the mountain/Three little drummers	mist_on_the_mountain_three_little_drummers
Money ain't a thing	money_ain't_a_thing
Money, cash, hoes	money_cash_hoes
Money for nothing	money_for_nothing
Rondeau fron Symphonies de fanfares	mouret_rondeau
Muistojen bulevardi	muistojen_bulevardi
Music makes you lose control	music_makes_you_lose_control
Music sounds better with you	music_sounds_better_with_you
My all	my_all
My baby by my side	my_baby_by_my_side
My heart will go on	my_heart_will_go_on
My joy is you	my_joy_is_you
Eine kleine nachtmusik: menuetto	nachtmusik_menuetto
Nearer my god to thee	nearer_my_god_to_thee
Neither one of us (wants to be the first to say goodbye)	neither_one_of_us
No Ordinary Love	no_ordinary_love
No sleep till Brooklyn	no_sleep_till_brooklyn
Noise alert	noise_alert
Nsambei	nsambei
Ó barquinho	o_barquinho
Oh papa	oh_papa
Old bones	old_bones
One	one
Oops! I did it again	oops!_i_did_it_again
Open up my heart	open_up_my_heart
Opposites Attract	opposites_attract
Sonate 1 f-moll: allegro moderato e serioso	organ_sonata1
The original sun	original_sun
Other side of the river	other_side_of_the_river
Over the rainbow	over_the_rainbow
Palvonnan eleitä	palvonnan_eleitä
Panama	panama
Paper chase	paper_chase
Parallel Universe	parallel_universe
Pavana con su glosa	pavana_con_su_glosa
Peacemakers	peacemakers
Peter and the Wolf	peter_and_the_wolf
Phlegmatic	phlegmatic
Piano Concerto in A minor = Allegro vivace	piano_concerto_in_a_minor-allegro_vivace
Pieni tulitikkutyttö	pieni_tulitikkutyttö
Probe (the Green Nuns of Revolution Mix)	probe_(green_nuns_of_the_revolution_remix)
Psycho circus	psycho_circus
Pulsewidth	pulsewidth
Punta del soul	punta_del_soul
Rainy night house	rainy_night_house
Rat kissed the cat	rat_kissed_the_cat
Rautakantele	rautakantele
Bolero	ravel_bolero
Real robots don't die	real_robots_don't_die
Rhapsody in rock IV	rhapsody_in_rock_IV
Rhymin & stealin	rhymin_and_stealin
The applejack	rhytmblues_morris
Teardrops from my eyes	rhytmblues_ruthbrown
Sweet sixteen	rhytmblues_turner
Tee nah nah	rhytmblues_walls
Ride across the river	ride_across_the_river
Rimsky	rimsky
River deep, mountain high	river_deep_mountain_high
Spring	squids
Roadhouse blues	roadhouse_blues
Room with a view	room_with_a_view
'Round midnight	round_midnight
Rua Dona Margarida	rua_dona_margarida
The Sabre dance	sabre_dance
San Antone	san_antone
Lester's bounce	sarpila_lester
Moon song	sarpila_moonsong
Rent party blues	sarpila_rentparty
Ecuador	sash_ecuador
Saturday in the park	saturday_in_the_park
Savoy blues	savoy_blues
Schmetterlinge	schmetterlinge
Science friction	science_friction
Segue o seco	segue_o_seco
Senza una donna	senza_una_donna
Serenade for strings in C major, op.48= II Walzer (moderato tempo di valse)	serenade_for_strings_in_c_major_op.48-II_walzer_(moderato_tempo_di_valse)
Seven steps to heaven	seven_steps_to_heaven
Shame	shame
She's a bitch	she's_a_bitch
She's strange (12" rap version)	she's_strange
She's not there	shes_not_there
Shoop	shoop
Shubbee's doobie	shubbees_doobie
Silence (DJ Tiesto mix)	silence_(dj_tiesto_remix)
Sip of tequila	sip_of_tequila
Skank it	skank_it
The trip (Roni Size mix)	skylab_trip
Really got the blues	slim_gottheblues
Tiajuana	slim_tiajuana
Smoke rings	smoke_rings
So what	so_what
Soi Kiitokseksi Luojan - Sing Now to the Creator	soi_kiitoksesi_luojan!_(sibelius)
Solo quiero caminar	solo_quiero_caminar
Solveig's song	solvejg's_song
Someday my prince will come	someday_my_prince_will_come
Somethin' stupid	somethin'_stupid
Something grand	something_grand
Sonata no.10 for Trumpet and strings= allegro/presto	sonata_no.10_for_trumpet_and_strings_allegro-presto
Song for Claire	song_for_claire
S.O.S	sos
Spanish rapsody	spanish_rhapsody
Sponge	sponge
Squelch	squelch
Squish	squids
Stan	stan
Heavy makes you happy	staplesingers_happy
Long walk to D.C.	staplesingers_longwalk
Respect yourself	staplesingers_respectyourself
Star 69	star_69
Starbright	starbright
Staring at the sun	staring_at_the_sun
Still waters run deep	still_waters_run_deep
Stomping grounds	stomping_grounds
Straighten up baby	straighten_up_baby
Strangers in the night	strangers_in_the_night
Street man	street_man
Suite in F major= Air	suite_in_f_major-_air
Suite in F major= Menuet	suite_in_f_major-_menuet
Summertime	summertime
Sun is shining	sun_is_shining
Outside world	sunbeam_outsideworld
Sunshine of your love	sunshine_of_your_love
Superstition	superstition
Surrender	surrender
Swamp music	swamp_music
Swanlake: Hungarian dance - Czardas	swanlake_hungarian_dance-czardas
Swanlake: Scene	swanlake_scene
Swanlake: Spanish dance	swanlake_spanish_dance
Sweet Dreams	sweet_dreams_(are_made_of_this)
Sweetheart	sweetheart
Take it away	take_it_away
Lady my whole world is you	taylor_worldisyou
That's all I need to know	that's_all_i_need_to_know
That's the way her love is	that's_the_way_her_love_is
That's the way (I like it)	thats_the_way(i_like_it)
The bells	the_bells
The devil you know	the_devil_you_know
The girl next door	the_girl_next_door
The great white buffalo	the_great_white_buffalo
The next episode	the_next_episode
The next movement	the_next_movement
The pink panther	the_pink_panther
The sound of silence	the_sound_of_silence
The spirit returns	the_spirit_returns
The supernatural	the_supernatural
The thrill is gone	the_thrill_is_gone
The unseen	the_unseen
The way I am	the_way_i_am
The zone	the_zone
Three times a lady	three_times_a_lady
Tiger rag	tiger_rag
Time after time	time_after_time
Tired of being alone	tired_of_being_alone
To Zion	to_zion
Tonight	tonight
Too soon tomorrow	too_soon_tomorrow
Serenata	toselli_serenata
Towards Dead End	towards_dead_end
Trash	trash
Turn	turn
Turn it up (Remix) Fire it up	turn_in_up_remix_fire_it_up
Tush	tush
Free	ultranate_free
Symphony no.8 Bb minor, The unfinished symphony: allegro moderato	unfinishedsymphony
Ungarischer tanz no.5	ungarischer_tanz
Upon 9th and Fairchild	upon_9th_and_fairchild
Ut och in på mig själv	ut_och_in_på_mig_själv
Ventanita Florida	ventanita_florida
Viajecito	viajecito
The four seasons concerto op.8 no.3: autumn allegro	vivaldi_autumn
The four seasons concerto op.8 no.1: Spring, allegro	vivaldi_spring
The four seasons concerto op.8 no.2: summer, presto	vivaldi_summer
The four seasons concerto op.8 no.4: winter, allegro non molto	vivaldi_winter
Serenade nr.2 F-dur für streichorchester:Allegro moderato	volkmann_allegromoderato
Voodoo child	voodoo_child
Voyager	voyager
Waterloo	waterloo
Watermelon man	watermelon_man_närpiö
Westwood moon	westwood_moon
What's it all about	what's_it_all_about
Whatta man	whatta_man
Wheatleigh Hall	wheatleigh_hall
When disaster strikes	when_disaster_strikes
Where blue begins	where_blue_begins
Wild woman	wild_woman
Within	within
Without justice	without_justice
Word is born	word_is_born
Xxplosive	xxplosive
You're still the one	you're_still_the_one
You are the sunshine of my life	you_are_the_sunshine_of_my_life
You Can Get It If You Really Want	you_can_get_it_if_you_really_want
You got me	you_got_me
Your crusade	your_crusade
You've got it bad girl	youve_got_it_bad_girl
Die Zauberflöte: ouverture	zauberflote
Zur Johannisnacht	zur_johannisnacht
Zyryab	zyryab
Übermorgenland	übermorgenland